{
  "metadata": {
    "description": "汉字到Emoji的映射表，可作为临时图标使用",
    "version": "1.0",
    "totalMappings": 250,
    "usage": "import emojiMap from './emoji-map.json'; const emoji = emojiMap.mappings[char];",
    "note": "部分抽象汉字使用了近似emoji，可根据需要替换"
  },
  "mappings": {
    "一": "1️⃣",
    "二": "2️⃣",
    "十": "🔟",
    "人": "🧑",
    "入": "🚪",
    "八": "8️⃣",
    "九": "9️⃣",
    "几": "🪑",
    "刀": "🔪",
    "力": "💪",
    "又": "✋",
    "三": "3️⃣",
    "上": "⬆️",
    "下": "⬇️",
    "土": "🟤",
    "大": "🔷",
    "小": "🔸",
    "口": "👄",
    "山": "⛰️",
    "千": "💯",
    "才": "🎓",
    "寸": "📏",
    "万": "💰",
    "干": "💼",
    "工": "👷",
    "己": "🙋",
    "已": "✅",
    "巾": "🧣",
    "弓": "🏹",
    "广": "🏢",
    "火": "🔥",
    "水": "💧",
    "木": "🪵",
    "日": "☀️",
    "月": "🌙",
    "天": "🌌",
    "手": "✋",
    "心": "❤️",
    "牛": "🐄",
    "毛": "🧶",
    "长": "📏",
    "风": "💨",
    "车": "🚗",
    "文": "📄",
    "方": "◻️",
    "片": "🍂",
    "牙": "🦷",
    "不": "❌",
    "中": "🎯",
    "五": "5️⃣",
    "六": "6️⃣",
    "今": "📅",
    "分": "➗",
    "公": "🏛️",
    "化": "🔄",
    "比": "⚖️",
    "开": "🔓",
    "见": "👀",
    "元": "💴",
    "无": "⭕",
    "云": "☁️",
    "太": "⭐",
    "井": "🕳️",
    "王": "👑",
    "气": "💨",
    "少": "➖",
    "从": "👥",
    "内": "📥",
    "为": "🎯",
    "田": "🌾",
    "目": "👁️",
    "耳": "👂",
    "石": "🪨",
    "禾": "🌾",
    "米": "🍚",
    "白": "⚪",
    "皮": "🧴",
    "鸟": "🐦",
    "生": "🌱",
    "东": "🧭",
    "西": "🌅",
    "南": "🧭",
    "北": "🧭",
    "左": "⬅️",
    "右": "➡️",
    "出": "🚪",
    "去": "🚶",
    "来": "👋",
    "半": "½",
    "本": "📖",
    "正": "✅",
    "平": "📊",
    "可": "✔️",
    "电": "⚡",
    "叶": "🍃",
    "号": "#️⃣",
    "句": "💬",
    "只": "1️⃣",
    "四": "4️⃣",
    "头": "🧠",
    "过": "✅",
    "江": "🌊",
    "红": "🔴",
    "回": "🔄",
    "在": "📍",
    "地": "🌍",
    "好": "👍",
    "她": "👩",
    "有": "✅",
    "年": "📆",
    "会": "🤝",
    "自": "🙋",
    "多": "➕",
    "后": "⏭️",
    "向": "➡️",
    "全": "💯",
    "竹": "🎋",
    "羊": "🐑",
    "衣": "👔",
    "花": "🌸",
    "草": "🌱",
    "树": "🌳",
    "林": "🌲",
    "果": "🍎",
    "瓜": "🍉",
    "豆": "🫘",
    "走": "🚶",
    "足": "🦶",
    "身": "🧍",
    "男": "👨",
    "妈": "👩",
    "爸": "👨",
    "我": "🙋",
    "你": "👉",
    "他": "👨",
    "们": "👥",
    "听": "👂",
    "说": "💬",
    "读": "📖",
    "鱼": "🐟",
    "虫": "🐛",
    "兔": "🐰",
    "狗": "🐶",
    "猫": "🐱",
    "马": "🐴",
    "鸡": "🐔",
    "鸭": "🦆",
    "猪": "🐷",
    "蛋": "🥚",
    "每": "📊",
    "时": "⏰",
    "早": "🌅",
    "明": "💡",
    "星": "⭐",
    "春": "🌸",
    "青": "💚",
    "雨": "🌧️",
    "雪": "❄️",
    "河": "🌊",
    "作": "✍️",
    "住": "🏠",
    "坐": "🪑",
    "站": "🧍",
    "把": "✊",
    "找": "🔍",
    "给": "🎁",
    "吃": "🍽️",
    "喝": "🥤",
    "玩": "🎮",
    "门": "🚪",
    "房": "🏠",
    "床": "🛏️",
    "桌": "🪑",
    "杯": "🥤",
    "笔": "✏️",
    "纸": "📄",
    "画": "🎨",
    "书": "📚",
    "包": "🎒",
    "家": "🏡",
    "校": "🏫",
    "园": "🏞️",
    "桥": "🌉",
    "船": "⛵",
    "飞": "✈️",
    "机": "⚙️",
    "路": "🛣️",
    "街": "🏙️",
    "城": "🏙️",
    "高": "🗼",
    "新": "🆕",
    "亮": "💡",
    "美": "😍",
    "笑": "😄",
    "哭": "😢",
    "唱": "🎤",
    "跳": "💃",
    "跑": "🏃",
    "睡": "😴",
    "衫": "👕",
    "帽": "🧢",
    "鞋": "👟",
    "袜": "🧦",
    "黄": "🟡",
    "蓝": "🔵",
    "绿": "🟢",
    "黑": "⚫",
    "圆": "⭕",
    "热": "🔥",
    "冷": "🧊",
    "暖": "☀️",
    "凉": "🌬️",
    "夏": "☀️",
    "秋": "🍂",
    "冬": "❄️",
    "晨": "🌅",
    "晚": "🌆",
    "昨": "📅",
    "爱": "❤️",
    "想": "💭",
    "知": "🧠",
    "道": "🛣️",
    "问": "❓",
    "答": "💬",
    "谢": "🙏",
    "帮": "🤝",
    "送": "📦",
    "借": "🤝",
    "买": "🛒",
    "卖": "💰",
    "钱": "💵",
    "块": "🧱",
    "菜": "🥬",
    "饭": "🍚",
    "面": "🍜",
    "汤": "🍲",
    "茶": "🍵",
    "奶": "🥛",
    "看": "👀",
    "着": "👁️",
    "呢": "❓",
    "吗": "❓",
    "吧": "💬",
    "啊": "😮",
    "哦": "😯",
    "哇": "😲",
    "嗯": "🤔",
    "喂": "📞"
  },
  "categories": {
    "数字": ["一", "二", "三", "四", "五", "六", "八", "九", "十"],
    "方位": ["上", "下", "左", "右", "东", "西", "南", "北", "中"],
    "颜色": ["白", "红", "青", "黄", "蓝", "绿", "黑"],
    "自然": ["山", "水", "火", "木", "日", "月", "天", "云", "风", "雨", "雪", "石", "江", "河"],
    "动物": ["牛", "羊", "鸟", "鱼", "虫", "兔", "狗", "猫", "马", "鸡", "鸭", "猪"],
    "植物": ["禾", "米", "花", "草", "树", "林", "果", "瓜", "豆", "叶", "竹"],
    "身体": ["人", "口", "手", "心", "目", "耳", "头", "足", "身", "牙"],
    "动作": ["走", "去", "来", "坐", "站", "吃", "喝", "玩", "听", "说", "读", "看"],
    "情感": ["笑", "哭", "爱"]
  },
  "usage": {
    "react": "const emojiMap = require('./emoji-map.json'); const icon = emojiMap.mappings[character];",
    "typescript": "import emojiMap from './emoji-map.json'; const icon: string = emojiMap.mappings[char];",
    "example": "<span style='fontSize: 64px'>{emojiMap.mappings['火']}</span> // 显示 🔥"
  }
}

